NO ./ass/mario_level/wall.xpm
SO ./ass/mario_level/wall.xpm
EA ./ass/mario_level/wall.xpm
WE ./ass/mario_level/wall.xpm

C 135,206,235
F 135,206,235
F 135,33,44

11111111
10100001
10100001
10000101
10000001
10E01001
10000001
11111111
