NO ./ass/mario_level/wall.xpm
SO ./ass/mario_level/wall.xpm
EA ./ass/mario_level/wall.xpm
WE ./ass/mario_level/wall.xpm

C 135,206,235
F 86,125,60

11111111
10100001
10100001
10000101
10000001
10001001
10000001
11111111



00000000
00000000
00101100
001W0100
00111100
00000000
