NO ./ass/mario_level/wall.xpm
SO ./ass/mario_level/wall.xpm
EA ./ass/mario_level/wall.xpm
WE ./ass/mario_level/wall.xpm

C 135,206,235
F 86,125,60


1111111111
1S11111001
1000000001
1001000001
1000000001
1000001101
1001000101
1000001101
1111111111
