NO ./ass/ice_level/wall.xpm
SO ./ass/ice_level/wall.xpm
EA ./ass/ice_level/wall.xpm
WE ./ass/ice_level/wall.xpm

C 135,206,235
F 86,125,60

111111111111111111111111111111111111111111111111111111111111111111111111111
100000000000000000000000000000000000000000000000000000000000000000000000001
100000000000000000000111000000000000000000000000001000000100011000000000001
101001001010101000100100000001000000000000000100000010010100000010101010101
100000000000000000000000000000000000000000000000000000000000000000000000001
100000000000000000000111000000000000000000000000001000000100011000000000001
101001001010101000100100000001000000000000000100000010010100000010101010101
100000000000000000000000000000000000000000000000000000000000000000000000001
100000000000000000000111000000000000000000000000001000000100011000000000001
101001001010101000100100000001000000000000000100000010010100000010101010101
1000000000000000000000000000000000000000N0000000000000000000000000000000001
100000000000000000000111000000000000000000000000001000000100011000000000001
101001001010101000100100000001000000000000000100000010010100000010101010101
100000000000000000000000000000000000000000000000000000000000000000000000001
100000000000000000000111000000000000000000000000001000000100011000000000001
101001001010101000100100000001000000000000000100000010010100000010101010101
100000000000000000000000000000000000000000000000000000000000000000000000001
100000000000000000000111000000000000000000000000001000000100011000000000001
101001001010101000100100000001000000000000000100000010010100000010101010101
111111111111111111111111111111111111111111111111111111111111111111111111111
