NO ./ass/pacman_level/wall.xpm
SO ./ass/pacman_level/wall.xpm
EA ./ass/pacman_level/wall.xpm
WE ./ass/pacman_level/wall.xpm

C 0,0,0
F 0,0,0

11111111111111111111111111111111111111111111111111111111111111111111111111
10000000000000000000000000000000000000000000000000000000000000000000000001
100S0000000000000000000000000000000000000000000000000000000000000000000001
10000000000000000000000000000000000000000000000000000000000000000000000001
10000000000000000000111111111100000000001111111110000000000000000000000001
10000000000000000000110000000000000000011000000011000000000000000000000001
10000000000000000000110000000000000000000000000011000000000000000000000001
10000000000000000000111111111100000000011000000011000000000000000000000001
10000000000000000000000000001100000000011000000011000000000000000000000001
10000000000000000000000000001100000000011000000000000000000000000000000001
10000000000000000000111111111100000000001111111110000000000000000000000001
10000000000000000000000000000000000000000000000000000000000000000000000001
10000000000000000000000000000000000000000000000000000000000000000000000001
10000000001100000000000001110011100000001110000001100000111111111000000001
10000000001100000000000011000000110000001101100001100001111111111000000001
10000000001100000000000011000000110000001100100001100001100000000000000001
10000000001100000000000011000000110000001100110001100001100001111110000001
10000000001100000000000011000000110000001100011001100001100000011000000001
10000000001100000000000011000000110000001100001001100001110000011000000001
10000000001111111110000001110011100000001100000111100000111111110000000001
10000000000000000000000000000000000000000000000000000000000000000000000001
10000000000000000000000000000000000000000000000000000000000000000000000001
11111111111111111111111111111111111111111111111111111111111111111111111111
