WE ./src/wall_2.xpm
NO ./src/wall_1.xpm
SO ./src/wall_4.xpm

EA ./src/wall_3.xpm

C 34,  	10,   1
F 1,1,225





      1  111111   11
    11E111  11111100111111
    100011  11110000000011      11
    110111  10000111111011     1001
    1100111110001111000011    10001
    1100000000111111000011111100001
    1111111100000000000000000001111
     111111111111111111111111111111
